5 10
|--------|
|.A.|..-.|
|..-|.@..|
|......-.|
|--------|
